11111111111111111111111
10000000000000100000101
10111011101010101110101
10100010001010101000001
10111010111110101111101
10000010001010100010101
11101110101010101010101
10100000100010101010101
10101010111110101010101
10001010000000000000001
11101111111010101111101
10000010100010100000101
10111010111111111011101
10100010000000000000101
10111010111011101111101
10100000000010000000001
10101110101111101011101
10101000101110001000101
11101010101111111011101
10001010000010100010001
11111011111010101011101
10000010000000001000001
11111111111111111111111
